R 1920 1080
NO assets/cabina1.xpm
SO assets/cabina2.xpm
WE assets/cabina3.xpm
EA assets/cabina4.xpm
S assets/sp.xpm

F 255,235,205
C 153,203,255




        1111111111111111111111111            1111
        10000000001000002000000011111111111110001
        1011000001110002W200000000000000000000001
        10010000002000002000000011111111111110001
111111111011000001110000000000001            1111
1000000000110000011101111111111111
11110111111111011100000010000000011111111111111111
11110111111111011101010011000000000000000000000001
11000000110101011100000000100020001111100000111101
10000000000000001100020010100000001   1000001  101
10000000000000001101000010000000001   1000001  101
11000001110101011111111110000000011   1000001  101
11110111 1110101 100000010000000001    11111   101
11110111111101111111011111111111111111111111111101
10000000000000000000020000000000000000000000000001
11111111111111111111111111111111111111111111111111

